##################################################
#################                                #
#               ########             #######     #
# ################      #           #            #
#     #         #  #### #           # # ####     #
# ############# # ##    #           # # ##       #
# #           # # ##### #######     # # ##########
# ##### ##### # #     #        #    # #         ##
#     # #   #  ###### # #### # #    # # ####### ##
# ## ## ###### #    # # #    # #    # # #      # #
#   #        # # #### # #    # #    #  ###########
  # # # #### # # #  # # #   #  #    ## #          
###   # #  # #    # # ###   # #######  # ####### #
# # # # ## # # ###### #     #      ## ## #     # #
# # # #   ## ####     #    ####### ##  # #     # #
# # # ### ##   ## #####    #     # ## ## #     # #
# # # # # # ## ## #   #    # #   # ## ## #     # #
#  ## # # #  #    #   #    # ##### ## ## ####### #
#   # # # #  ## ##### ######     # ## ##         #
#   #     #   # #                #       ## #### #
#   #######   # ##### ### #      ##########     ##
#             #       # # #  #####        #     ##
#             #3####### # # ##            ########
##################################################
