'#','#','#','#','#','#','#','#','#','#','#','#','#','#','#','#','#','#','#','#','#','#','#','#','#','#','#','#','#','#','#','#','#','#','#','#','#','#','#','#','#','#','#','#','#','#','#','#','#','#',
'#','#','#','#','#','#','#','#','#','#','#','#','#','#','#','#','#',' ',' ',' ',' ',' ',' ',' ',' ',' ',' ',' ',' ',' ',' ',' ',' ',' ',' ',' ',' ',' ',' ',' ',' ',' ',' ',' ',' ',' ',' ',' ',' ','#',
'#',' ',' ',' ',' ',' ',' ',' ',' ',' ',' ',' ',' ',' ',' ',' ','#','#','#','#','#','#','#','#',' ',' ',' ',' ',' ',' ',' ',' ',' ',' ',' ',' ',' ','#','#','#','#','#','#','#',' ',' ',' ',' ',' ','#',
'#',' ','#','#','#','#','#','#','#','#','#','#','#','#','#','#','#','#',' ',' ',' ',' ',' ',' ','#',' ',' ',' ',' ',' ',' ',' ',' ',' ',' ',' ','#',' ',' ',' ',' ',' ',' ',' ',' ',' ',' ',' ',' ','#',
'#',' ',' ',' ',' ',' ','#',' ',' ',' ',' ',' ',' ',' ',' ',' ','#',' ',' ','#','#','#','#',' ','#',' ',' ',' ',' ',' ',' ',' ',' ',' ',' ',' ','#',' ','#',' ','#','#','#','#',' ',' ',' ',' ',' ','#',
'#',' ','#','#','#','#','#','#','#','#','#','#','#','#','#',' ','#',' ','#','#',' ',' ',' ',' ','#',' ',' ',' ',' ',' ',' ',' ',' ',' ',' ',' ','#',' ','#',' ','#','#',' ',' ',' ',' ',' ',' ',' ','#',
'#',' ','#',' ',' ',' ',' ',' ',' ',' ',' ',' ',' ',' ','#',' ','#',' ','#','#','#','#','#',' ','#','#','#','#','#','#','#',' ',' ',' ',' ',' ','#',' ','#',' ','#','#','#','#','#','#','#','#','#','#',
'#',' ','#','#','#','#','#',' ','#','#','#','#','#',' ','#',' ','#',' ',' ',' ',' ',' ','#',' ',' ',' ',' ',' ',' ',' ',' ','#',' ',' ',' ',' ','#',' ','#',' ',' ',' ',' ',' ',' ',' ',' ',' ','#','#',
'#',' ',' ',' ',' ',' ','#',' ','#',' ',' ',' ','#',' ',' ','#','#','#','#','#','#',' ','#',' ','#','#','#','#',' ','#',' ','#',' ',' ',' ',' ','#',' ','#',' ','#','#','#','#','#','#','#',' ','#','#',
'#',' ','#','#',' ','#','#',' ','#','#','#','#','#','#',' ','#',' ',' ',' ',' ','#',' ','#',' ','#',' ',' ',' ',' ','#',' ','#',' ',' ',' ',' ','#',' ','#',' ','#',' ',' ',' ',' ',' ',' ','#',' ','#',
'#',' ',' ',' ','#',' ',' ',' ',' ',' ',' ',' ',' ','#',' ','#',' ','#','#','#','#',' ','#',' ','#',' ',' ',' ',' ','#',' ','#',' ',' ',' ',' ','#',' ',' ','#','#','#','#','#','#','#','#','#','#','#',
'#',' ','#',' ','#',' ','#',' ','#','#','#','#',' ','#',' ','#',' ','#',' ',' ','#',' ','#',' ','#',' ',' ',' ','#',' ',' ','#',' ',' ',' ',' ','#','#',' ','#',' ',' ',' ',' ',' ',' ',' ',' ',' ',' ',
'#','#','#',' ',' ',' ','#',' ','#',' ',' ','#',' ','#',' ',' ',' ',' ','#',' ','#',' ','#','#','#',' ',' ',' ','#',' ','#','#','#','#','#','#','#',' ',' ','#',' ','#','#','#','#','#','#','#',' ','#',
'#',' ','#',' ','#',' ','#',' ','#','#',' ','#',' ','#',' ','#','#','#','#','#','#',' ','#',' ',' ',' ',' ',' ','#',' ',' ',' ',' ',' ',' ','#','#',' ','#','#',' ','#',' ',' ',' ',' ',' ','#',' ','#',
'#',' ','#',' ','#',' ','#',' ',' ',' ','#','#',' ','#','#','#','#',' ',' ',' ',' ',' ','#',' ',' ',' ',' ','#','#','#','#','#','#','#',' ','#','#',' ',' ','#',' ','#',' ',' ',' ',' ',' ','#',' ','#',
'#',' ','#',' ','#',' ','#','#','#',' ','#','#',' ',' ',' ','#','#',' ','#','#','#','#','#',' ',' ',' ',' ','#',' ',' ',' ',' ',' ','#',' ','#','#',' ','#','#',' ','#',' ',' ',' ',' ',' ','#',' ','#',
'#',' ','#',' ','#',' ','#',' ','#',' ','#',' ','#','#',' ','#','#',' ','#',' ',' ',' ','#',' ',' ',' ',' ','#',' ','#',' ',' ',' ','#',' ','#','#',' ','#','#',' ','#',' ',' ',' ',' ',' ','#',' ','#',
'#',' ',' ','#','#',' ','#',' ','#',' ','#',' ',' ','#',' ',' ',' ',' ','#',' ',' ',' ','#',' ',' ',' ',' ','#',' ','#','#','#','#','#',' ','#','#',' ','#','#',' ','#','#','#','#','#','#','#',' ','#',
'#',' ',' ',' ','#',' ','#',' ','#',' ','#',' ',' ','#','#',' ','#','#','#','#','#',' ','#','#','#','#','#','#',' ',' ',' ',' ',' ','#',' ','#','#',' ','#','#',' ',' ',' ',' ',' ',' ',' ',' ',' ','#',
'#',' ',' ',' ','#',' ',' ',' ',' ',' ','#',' ',' ',' ','#',' ','#',' ',' ',' ',' ',' ',' ',' ',' ',' ',' ',' ',' ',' ',' ',' ',' ','#',' ',' ',' ',' ',' ',' ',' ','#','#',' ','#','#','#','#',' ','#',
'#',' ',' ',' ','#','#','#','#','#','#','#',' ',' ',' ','#',' ','#','#','#','#','#',' ','#','#','#',' ','#',' ',' ',' ',' ',' ',' ','#','#','#','#','#','#','#','#','#','#',' ',' ',' ',' ',' ','#','#',
'#',' ',' ',' ',' ',' ',' ',' ',' ',' ',' ',' ',' ',' ','#',' ',' ',' ',' ',' ',' ',' ','#',' ','#',' ','#',' ',' ','#','#','#','#','#',' ',' ',' ',' ',' ',' ',' ',' ','#',' ',' ',' ',' ',' ','#','#',
'#',' ',' ',' ',' ',' ',' ',' ',' ',' ',' ',' ',' ',' ','#',' ','#','#','#','#','#','#','#',' ','#',' ','#',' ','#','#',' ',' ',' ',' ',' ',' ',' ',' ',' ',' ',' ',' ','#','#','#','#','#','#','#','#',
'#','#','#','#','#','#','#','#','#','#','#','#','#','#','#','#','#','#','#','#','#','#','#','#','#','#','#','#','#','#','#','#','#','#','#','#','#','#','#','#','#','#','#','#','#','#','#','#','#','#'
